PSSSPMPPMM
SESSSSSSSS
PPPPPPSMSD
PSSSSSSPSP
PPPPMPPPPP
PPPSPPPPPP
SSPSSSSSSP